1,1,3,0,0,0,0,0,0,0,0,0,0,0
4,5,6,0,0,0,0,0,0,0,0,0,0,0
2,1,2,0,0,0,0,0,0,0,0,0,0,0
0,0,0,0,0,0,0,0,0,0,0,0,0,0
0,0,0,0,0,0,0,0,0,0,0,0,0,0