3,2,1,0,0,0,0,0,0,0,0,0,0,0
44,2,9,0,0,0,0,0,0,0,0,0,0,0
1,3,8,0,0,0,0,0,0,0,0,0,0,0
0,0,0,0,0,0,0,0,0,0,0,0,0,0
0,0,0,0,0,0,0,0,0,0,0,0,0,0